..............
..............
..............
..............
WWWWWWWWWWWWWW
.....WWWW.....
..............
..............
..............
..............