..............
.....YYYY.....
WWWWW....WWWWW
..............
..............
..............
.WWWWW..WWWWW.
..............
...W..WW..W...
..............