WWWW......WWWW
WW..........WW
..............
..............
.Y.Y.Y.Y.Y.Y.Y
Y.Y.Y.Y.Y.Y.Y.
..............
..............
..............
WWWWWWWWWWWWWW