..............
...WWWWWWWW...
YYY........YYY
..............
WYYYYYYYYYYYYW
.W..........W.
W.WWWWWWWWWW.W
..............
..............
..............