..............
..............
..............
NNN........HHH
..............
WWWWWWWWWWWWWW
..............
..............
..............
..............