..............
HNHNHNHNHNHNHN
......YY......
...WWW..WWW...
YYY........YYY
..............
NHNHNHNHNHNHNH
..............
..............
..............