WYYYYYYYYYYYYY
..............
YYYYYYYYYYYYYW
NNHHNNHHNNHHNN
..............
.......HHHHHHH
NNNNNNN.......
..............
..............
..............