...HHHHHHHH...
....NNNNNN....
.....HHHH.....
NNNNNNNNNNNNNN
WY...H..H...YW
Y...N....N...Y
...H......H...
..N.N....N.N..
.H...H..H...H.
N.....NN.....N