..............
..............
NNNNNNNHHHHHHH
YYYYYYYYYYYYYY
NNHHNNHHNNHHNN
WWWWWWWWWWWWWW
HHNNHHNNHHNNHH
WWWWWWWWWWWWWW
NNHHNNHHNNHHNN
..............