..............
..............
..............
WWWWWWYYWWWWWW
..............
..BBBB..GGGG..
..............
HNHNHNHNHNHNHN
..............
..............