..............
..............
..............
..............
.B..B..B..B..B
G..G..G..G..G.
..B..B..B..B..
.G..G..G..G..G
B..B..B..B..B.
..............