.GG.GG.Y......
G..G..GY......
G..G..GY......
G..G..GY......
G..G..GYBBBB..
.......YB...B.
.......YBBBB..
.......YB...B.
.......YB...B.
.......YBBBB..