........GGGGGG
....GGGG......
..GG..........
.G......BBB...
..G...GB...B..
...GGG......B.
..........BB..
......BBBB....
BBBBBB........
YYYYYYYYYYYYYY