B...B...B...B.
..B...B...B...
NNNNNNNNNNNNNN
......RR......
R............R
..............
..............
..............
..............
..............