R.............
...Y.....R....
..............
..W..........R
.........R.W..
.R....R.......
...W..R..YY...
.W............
R....R.....R..
..............