RR..........RR
..............
.HNHHNNH......
..............
.......HHHH...
..............
NNNNNN........
..............
..............
..............