.......G......
............B.
..BH....R...N.
NNNNNNBBWWYYNN
........Y.....
....N.......W.
......W.......
HGHGH....HGHGH
..............
.NNNBBBBNNNNB.