R...H....H...R
R..H......H..R
..H..RRRR..H..
G............G
G.R..NNNN..R.G
G............G
..............
R...WRRRRW...R
R...WWYYWW...R
R............R