..............
..............
..............
YYYYGGGGGYYYY
....GNNNG.....
....GNLNG.....
....GNNNG.....
....GGGGG.....
..............
..............