....LRRRL.....
.....LLL......
..............
GHGH......HGHG
...WW....WW...
..BNBN..NBNB..
..............
..HH..HH..HH..
..............
BB..BB..BB..BB