.GG...RR...GG.
...GGGNNGGG...
...NNNGGNNN...
.NN...LL...NN.
N.....LL.....N
.NN...LL...NN.
...NNNGGNNN...
...GGGNNGGG...
.GG........GG.
G............G