R....LLLL....R
....LL..LL....
...LL....LL...
...L..WW..L...
...L..WW..L...
...LL....LL...
....LL..LL....
.....LLLL.....
..............
R............R