RRRRRRRRRRRRRR
..............
GGG..HHHH..GGG
..............
.BBB.NNNN.BBB.
..WWWYYYYWWW..
....BNHGWY....
..LLLLLLLLLL..
LLLLL....LLLLL
LL..........LL